bbbbbbbbbbbbbbbbbbbbbbbbbbbbb
b                           b
b         zzz    e          b
b e                   xxx   b
b       xxx     xx          b
b       bbb     bb          b
b       bbb     bb          b
b       bbb                 b
b       bbb      xxx        b
b       bbb            e    b
b       bbb     xxx         b
b                           b
b     zzz                   b
b                   xxxx    b
b       e           bb      b
b          xxx              b
b           bb       e      b
b                           b
b   xxxx                    b
b    bb           zzz xx    b
b          e          b     b
b             xx            b
b                           b
bxxxxxxxxxxxxxxxxxxxxxxxxxxxb